17
19
00000000000000000
01111111011111110
01000001010000010
01211111111111210
01010100000101010
01010111011101010
01010001010001010
01110888888801110
00010808580801000
88811806470811888
00010800000801000
01110888388801110
01011100000111010
01000111111100010
01021100000112010
01110111011101110
01000001010000010
01111111111111110
00000000000000000
